1111111111111111111111111-
4414441444411111111111111-
1414141411411111111111111-
1414141411411111111111111-
1414141411411111111111111-
1414141411411111111111111-
1414141411411111111111111-
1444144411441111111111111-
1111111111111111111111111-
1111111111111111111111111